[^a-zA-Z]
[^a-zA-Z]
stated	said
Stated	Said
STATED	SAID
walked	went
Walked	Went
WALKED	WENT
looked	saw
Looked	Saw
LOOKED	SAW

[^a-zA-Z]
[^a-zA-Z]
declared	said
Declared	Said
DECLARED	SAID
ran	went
Ran	Went
RAN	WENT
gazed	saw
Gazed	Saw
GAZED	SAW

[^a-zA-Z]
[^a-zA-Z]
exclaimed	said
Exclaimed	Said
EXCLAIMED	SAID
rushed	went
Rushed	Went
RUSHED	WENT
stared	saw
Stared	Saw
STARED	SAW

[^a-zA-Z]
[^a-zA-Z]
replied	said
Replied	Said
REPLIED	SAID
hurried	went
Hurried	Went
HURRIED	WENT
glanced	saw
Glanced	Saw
GLANCED	SAW

[^a-zA-Z]
[^a-zA-Z]
answered	said
Answered	Said
ANSWERED	SAID
strolled	went
Strolled	Went
STROLLED	WENT
watched	saw
Watched	Saw
WATCHED	SAW

[^a-zA-Z]
[^a-zA-Z]
remarked	said
Remarked	Said
REMARKED	SAID
marched	went
Marched	Went
MARCHED	WENT
observed	saw
Observed	Saw
OBSERVED	SAW

[^a-zA-Z]
[^a-zA-Z]
whispered	said
Whispered	Said
WHISPERED	SAID
dashed	went
Dashed	Went
DASHED	WENT

[^a-zA-Z]
[^a-zA-Z]
shouted	said
Shouted	Said
SHOUTED	SAID
sprinted	went
Sprinted	Went
SPRINTED	WENT

[^a-zA-Z]
[^a-zA-Z]
muttered	said
Muttered	Said
MUTTERED	SAID
