[^a-zA-Z]
[^a-zA-Z]
years	year
Years	Year
YEARS	YEAR
days	day
Days	Day
DAYS	DAY
times	time
Times	Time
TIMES	TIME
people	person
People	Person
PEOPLE	PERSON
things	thing
Things	Thing
THINGS	THING
children	child
Children	Child
CHILDREN	CHILD
ways	way
Ways	Way
WAYS	WAY
words	word
Words	Word
WORDS	WORD
books	book
Books	Book
BOOKS	BOOK
places	place
Places	Place
PLACES	PLACE
cases	case
Cases	Case
CASES	CASE
groups	group
Groups	Group
GROUPS	GROUP
problems	problem
Problems	Problem
PROBLEMS	PROBLEM
facts	fact
Facts	Fact
FACTS	FACT
months	month
Months	Month
MONTHS	MONTH
weeks	week
Weeks	Week
WEEKS	WEEK
hours	hour
Hours	Hour
HOURS	HOUR
minutes	minute
Minutes	Minute
MINUTES	MINUTE
points	point
Points	Point
POINTS	POINT
parts	part
Parts	Part
PARTS	PART
members	member
Members	Member
MEMBERS	MEMBER
areas	area
Areas	Area
AREAS	AREA
students	student
Students	Student
STUDENTS	STUDENT
companies	company
Companies	Company
COMPANIES	COMPANY
numbers	number
Numbers	Number
NUMBERS	NUMBER
systems	system
Systems	System
SYSTEMS	SYSTEM
programs	program
Programs	Program
PROGRAMS	PROGRAM
questions	question
Questions	Question
QUESTIONS	QUESTION
governments	government
Governments	Government
GOVERNMENTS	GOVERNMENT
countries	country
Countries	Country
COUNTRIES	COUNTRY
cities	city
Cities	City
CITIES	CITY
states	state
States	State
STATES	STATE
services	service
Services	Service
SERVICES	SERVICE
results	result
Results	Result
RESULTS	RESULT
