[^a-zA-Z]
[^a-zA-Z]
bad	good
Bad	Good
BAD	GOOD
cold	hot
Cold	Hot
COLD	HOT
slow	fast
Slow	Fast
SLOW	FAST
weak	strong
Weak	Strong
WEAK	STRONG
dark	light
Dark	Light
DARK	LIGHT
old	new
Old	New
OLD	NEW
wrong	right
Wrong	Right
WRONG	RIGHT
poor	rich
Poor	Rich
POOR	RICH
short	long
Short	Long
SHORT	LONG
hard	soft
Hard	Soft
HARD	SOFT
empty	full
Empty	Full
EMPTY	FULL
dead	alive
Dead	Alive
DEAD	ALIVE
cheap	expensive
Cheap	Expensive
CHEAP	EXPENSIVE
dry	wet
Dry	Wet
DRY	WET
